19 14
10 11
00000000000WWWWWWWW
00000000000WFFTTTTW
WWWWWWWWWWWWFFTTTTW
WFFFFWFFBFBFFFTTTTW
WFBBBWBFFBFWFFTTTTW
WFFBFFFFFBFWFFTTTTW
WFBBFWBFBFBWWWWWWWW
WFFBFWFFFFFW0000000
WWFWWWWWWWWW0000000
WFFFFWFFFFW00000000
WFFFFFBFFFWW0000000
WFFBBWBBFFFW0000000
WFFFFWFFFFWW0000000
WWWWWWWWWWW00000000
