18 16
8 3
00WWWW000000000000
00WFFWWWWWWWWW0000
0WWFFWWFFWFFFW0000
0WFFBWFBFBFFFWWWW0
0WBFFBFFWFBFBWFFWW
WWFFBWWFWBFBFFFFFW
WFFWFFWFWFFFBBBFFW
WFBFFFFBFFBWWFWWWW
WFBFBFWBWFFWFFW000
WWFFWWWFFWWWBFW000
0WFFWTTTTFFFFFW000
0WWWWTTTTTTWWWW000
000WTTTTWWWW000000
000WTTTWW000000000
000WTTTW0000000000
000WWWWW0000000000
