19 13
11 4
WWWWW00000000000000
WFFFWW0000000000000
WFBFFWWWWWWWWW00000
WWFWFWFFFFFFFWWWWWW
WWFWFFFBWBWFFFWFFFW
WFFWFFFFFFBFWFFFBFW
WFFWWWFWWWWWWWWWFWW
WFFWWFTTCTTTTTFWFW0
WWFWWFCTCTTCTCFWFWW
WFBWWWWWWWWWWFWWBFW
WFFBFFFBFFBFFFFBFFW
WFFWFFFWFFFWFFFWFFW
WWWWWWWWWWWWWWWWWWW
