19 16
6 1
00WWWWWW00000000000
00WFFFFWWWW00000000
WWWWWFBFFFW00000000
WFFFWWFFFFWWWW00000
WFBFWFFWWFFFFW00000
WFBFWFFWWWWWFW00000
WWFBFFBFFFFWFW00000
0WFBFBFWWWFWFW00000
0WFWFFBFFWFWFW00000
0WFWFWBWFFFWFW00000
WWFWWWFFFWFWFWWWWWW
WFFBFFWWWWFWFWTTTTW
WFFFFBFFFFBFFFTTWTW
WWWWBFFBWFBFFFTTTTW
WFFFFFFFWFFWWFTTTTW
WWWWWWWWWWWWWWWWWWW
