16 14
2 10
000WWWWWWWWWW000
000WTTFFWFFFW000
000WTTFFFFFFW000
000WTTFFWFFWWWW0
00WWWWWWWFFWFFWW
00WFFFFFFFFFFFFW
00WFFWFFWWFFWFFW
WWWWFWWFFWWWWFWW
WFFBFFWWWWWFWFFW
WFWFBFFBFFWFBFFW
WFFBFFBFFFWFFFWW
WWWWFWWFWWWWWWW0
000WFFFFW0000000
000WWWWWW0000000
