19 15
9 13
WWWWWWWWWWW00000000
WTTTTTTFFFWWWWWWWWW
WTTTTTTFFFWFFWWFFFW
WTTWWWFBFFFFBFFFFFW
WTTTFBFBFWFFWWWFFFW
WTTTWBWWWWWFFFFWFFW
WWWFFFFWFFFWBFFWBFW
00WFFBBFBFBFFBWWFFW
00WFFBFFFWBWBFWWBFW
00WWWFWWFWFFFFWWFFW
000WFFBFBFWWFWWWWWW
000WFFFFBFFBFFW0000
000WWFFFWFWFFFW0000
0000WWWWWFWWWWW0000
00000000WWW00000000
