19 15
7 2
0000000000WWWW00000
00000WWWW0WFFW00000
000WWWFFWWWBFW00000
00WWFFFFFFBFFW00000
0WWFFBFBBWWFWW00000
0WFFWBWWFFFFFW00000
0WFWFBFBBFWFWWW0000
0WFFFBFWFFWFBFWWWWW
0WWWFFFFWFFBBFWFFFW
WWWWFWWFBFFFFFFFFFW
WTFFFFWWWFFWWWWWWWW
WTTFTTW0WWWW0000000
WTTTWTW000000000000
WTTTTTW000000000000
WWWWWWW000000000000
