16 14
5 9
WWWWW0WWWW000000
WTTTW0WFFWWWW000
WTTTWWWFFBFFW000
WTTTTWWFBFFBWWW0
WWTTTTWWFFFBFFW0
WWWTTTFWWFBFBFW0
WFWWFFFFWFFBFFW0
WFFWWFWFWWWFWWWW
WFBFWFWBFFBFFFFW
WFFBFFFBFFFFBFFW
WFFFWFBFBBFBFWWW
WFFWWWWWWFFWWW00
WFWW0000WWWW0000
WWW0000000000000
