14 15
10 3
0WWWWWWWWW0000
0WTTTTFFFWW000
0WTWTWFFBFWW00
WWTTTTWFWFFWW0
WFTTTTWFFWFFWW
WFFFFFWBFWWBFW
WWFWWWFFBFFFFW
0WBFFBFBFBWFFW
0WFWFFBFBFWWFW
0WFFWWWFFWWFFW
0WFFFFWWFWWFWW
0WFFBFWFFBFFW0
0WWWBFBFFFWWW0
000WFFWWWWW000
000WWWW0000000
