13 16
6 13
00WWWWWWWWW00
00WCTCWCTCW00
00WTCTCTCTW00
00WCTCTCTCW00
00WTCTCTCTW00
00WCTCTCTCW00
00WWWFFFWWW00
0000WFFFW0000
WWWWWWFWWWWWW
WFFFFFFFFFFFW
WFBFBFBFBFBFW
WWFBFBFBFBFWW
0WBFBFBFBFBW0
0WFFFBFBFFFW0
0WFFWWWWWFFW0
0WWWW000WWWW0
