13 12
5 2
0000000WWWWW0
0WWWWWWWFFFWW
WWFWFFWWFBBFW
WFFFFBFFFFFFW
WFFBFFWWWFFFW
WWWFWWWWWBWWW
WFBFFWWWFTTW0
WFBFBFBFTTTW0
WFFFFWWWTTTW0
WFBBFW0WTTTW0
WFFWWW0WWWWW0
WWWW000000000
