12 15
10 10
0WWWWWWWWWWW
0WFFFFFWWFFW
0WFFFBFFFBFW
WWWWFWWFBBFW
WFFFBFWFFFFW
WFBBBFWFWWWW
WFFFWFWFBFWW
WFFWFFWFFBFW
WFBWFBWFFFFW
WFFFTTWFWWWW
WWWWTTFBFWFW
WTTTTTWFBWFW
WWTTTTWFFBFW
0WWTTWWFFFFW
00WWWWWWWWWW
