19 16
3 14
WWWWWWWWWWWWWWW0000
WTTTTTTTTTTFFTWWWW0
WTTTTTTTTTTBBTWFFW0
WWWWWWWWWWWBFWFFFWW
WFFFFFFBFFBFFFFFBFW
WWFWWWWFFFWFFBFWFFW
WFFFFFFWFFFWWFFWFWW
WFFBWFFWFWWFFWWWFW0
WFBFWBWWWFFFFWFWFW0
WWWFFBFWFFWFFWWWFW0
0WWFFFFBFWWFWFFWFWW
0WFBFFWFFBFFBFBFFFW
0WFFBFFBWBBBFFWFFFW
0WFFWFFBFFFFFFWWWWW
0WFFWWFFWFFWFFW0000
0WWWWWWWWWWWWWW0000
