19 13
10 11
0WWWWWWWWWWWWWWWWW0
0WTTTFFFWFFFFWFFFWW
WWTTTTTFFBWWFWFWBFW
WTTTTTTWFFBFFWFFFFW
WTTTTTTWFFWFFWFWFFW
WWWWWWWWWFBFFBFBFFW
00WFFFFFWBWWBFWWBWW
0WWFFFBFFFFWFBFFFFW
0WFFWWFWWWFWFFWWBFW
0WFBFBBFFFFFBFFBFFW
0WFBFFFFBWWBFWWWWWW
0WWWWWWWFFFFWW00000
0000000WWWWWW000000
