16 15
7 11
0000000WWWW00000
0000000WFFWW0000
0000000WFFFWW000
0000000WFBBFWW00
00000WWWBFFBFWW0
00WWWWFFFFBFFFW0
WWWFFWFWWWWWFFW0
WFFFFWFWTTTTBFW0
WFWFFFBFTTTTWFW0
WFFBFWFWTCTTWFW0
WWWFFWWWWFWWWFW0
00WWWWFFBFFWWBWW
00000WWWFBFFFFFW
0000000WFFWWFFFW
0000000WWWWWWWWW
