17 14
1 10
0000000000WWWWWWW
0000000000WFFTTTW
000000WWWWWFFTTTW
000000WFFFFFFTFTW
000000WFFWWFFTTTW
000000WWFWWFFTTTW
00000WWWFWWWWWWWW
00000WFBBBFWW0000
0WWWWWFFBFBFWWWWW
WWFFFWBFBFFFWFFFW
WFFBFFBFFFFBFFBFW
WWWWWWFBBFBFWWWWW
00000WFFFFFFW0000
00000WWWWWWWW0000
