19 14
5 5
0000000WWWWWWWWWWW0
0000000WFFFWFFFFFW0
WWWWW00WFFFFFBFBFW0
WFFFWWWWWFBWWFWFWW0
WFBFWWFFFWFWWFBFFW0
WFBFFFBBFWFWWBBBFW0
WWFWWWFFFWFWWFFFFW0
0WFWFFFWWWFWWWWWBW0
WWFWFFFFFBFFWTTTTW0
WFFWWWFWWFBFWTTTTWW
WFBFFFBFWFFFWTTBTFW
WFFWWFBFWFFWWTTTTFW
WWWWWFFFWWWWWWTTTWW
0000WWWWW0000WWWWW0
