12 11
9 1
WWWWWW00WWW0
WTTFFW0WWFWW
WTTFFWWWFFFW
WTTFFFFFBBFW
WTTFFWFWFBFW
WTTWWWFWFBFW
WWWWFBFWBFFW
000WFFBWFBFW
000WFBFFBFFW
000WFFWWFFFW
000WWWWWWWWW
