18 13
16 2
00000WWWWWWWW00000
00WWWWFFFFFFWWWWWW
00WFFFFWWFBFBFFFFW
00WFWWFWWBWBFBFBWW
WWWFTTTTTTWFFBBFWW
WFFFTTTTTTWFFWFFFW
WFWFTTTTTTWBFFBFFW
WFWFTTTTTTFBBWFBFW
WFBFWWWFWWWBFFBFWW
WWWFFBFFBFFBFFBFW0
00WFFBFFBFFBFFBFW0
00WWWWWWFFFWWWWWW0
0000000WWWWW000000
