19 15
17 8
00000000000WWWWW000
0000000000WWFFFWW00
000000000WWFFFFFW00
00000000WWFFBBFFW00
0000000WWFBBFFBFW00
0000000WFBFFFFBFW00
WWWW000WFFFBBFWWWWW
WFFWWWWWWWWFWWFFFFW
WTFFFFFFFFFFFFBBBFW
WTWFWWWWWWWFWWFFFWW
WTWFWWWWWWWTFWBFBWW
WTTTTTTTTTTTFWFFFFW
WWWWWWWWWWWWWWFFBFW
0000000000000WWFFWW
00000000000000WWWW0
