19 11
11 8
0000WWWWW0000000000
0000WFFFW0000000000
0000WBFFW0000000000
00WWWFFBWW000000000
00WFFBFBFW000000000
WWWFWFWWFW000WWWWWW
WFFFWFWWFWWWWWFFTTW
WFBFFBFFFFFFFFFFTTW
WWWWWFWWWFWFWWFFTTW
0000WFFFFFWWWWWWWWW
0000WWWWWWW00000000
