15 15
4 4
WWWWWWWWW000000
WFFFFFFFW000000
WFFFFFFFWWWW000
WWFWWWWFWFFW000
WWFWFWWFFFFW000
WFBBBFBFFBBW000
WFFWFWWFBFFW000
WFFWFWWFFBFWWWW
WWWWFFBBBFBWFFW
0WFFFWWFFFTTTTW
0WFWFFFWFWTTFTW
0WFFFWFWFWWTTTW
0WWWWWFBFFWTTTW
00000WWFFFWWWWW
000000WWWWW0000
