14 15
3 5
WWWWW000000000
WFFFWW00000000
WFFFFW00WWWW00
WFBFFWWWWFFW00
WFFBBFBFFFBW00
WWWFFWBFFFFWW0
0WFFWWFFBFBFWW
0WFBFFWWFWWFTW
0WFFWBWWBFFWTW
0WWWFFFBTTWWTW
00WFFFFWTCTTTW
00WFBBFWTTTTTW
00WFFWWWWWWWWW
00WFFW00000000
00WWWW00000000
