16 16
1 6
00WWWW0000000000
00WFFWWWWWWWWWWW
00WFFFFBFFFBFBFW
00WFBWFBFWFFBFFW
00WFFBFBFFWFFFFW
WWWFBWFWFFWWWWFW
WFWBFBFBFFWWFFFW
WFFFFBFWBWFFFWFW
WFFFBFFFFBFBFBFW
WWWWWFFWWWWWWWWW
00WFFFFFFW000000
00WFFFFFFW000000
00WTTTTTTW000000
00WTTTTTTW000000
00WTTTTTTW000000
00WWWWWWWW000000
