19 13
13 2
00000WWWWWWWWWWW000
00000WFFTFFWFFFW000
00000WFWTFFFFFFW000
0WWWWWFWWTTWFWWWW00
WWFFWFTTWWWFFFFFWWW
WFBFWTTTFFFBFWFFBFW
WFFFFTTFWWFFWWFWWFW
WWWWBWWBWFBFWFFFWFW
00WWFWFFFFWBFBBFWFW
00WFFBFWFWFFWFBWWFW
00WFFFFFFFFFFFFFFFW
00WFFWWWWWWWWWWWFFW
00WWWW000000000WWWW
