19 16
14 2
0000WWWWWWWWWW00000
WWWWWFFFFFFFFWWWW00
WFFFFFWFFFBFFWFFW00
WFWWWWWWWBWWWWFFWWW
WFWFFFFWWFWFFWBFTTW
WFWFBFFBFFWFFWFFWTW
WFWFBFFWFFFFFWBFTTW
WFWFFWWWFWWFFFFFWTW
WFWWWFFWFFWFFWBFTTW
WFWFFFFWFBWWWWFFWTW
WFWBFFFBFFBFFWCFTTW
WFFFFBFWFBFBFWFFWTW
WWWWFBWWWFFFFWCFTTW
000WFFFFBBFWWWTTTTW
000WFFFFFFWW0WWWWWW
000WWWWWWWW00000000
