19 15
9 3
0WWWWW0000000000000
0WFFFW0000000000000
0WFWFWWWWWW00000000
0WFFFFFFBFWWWWWW000
0WFBFWWBFWWWFFFW000
0WFWWWWFBFFFFBFW000
0WFWWFWWFWFFWBFWWWW
WWFFWWWWFWWBFFFFFFW
WFFBWFFBFFWFWWFWWFW
WFFFFFFFFFWFWTTTWFW
WWWWWWFFWWWFFTTTFFW
00000WWWW0WFWTTTWFW
0000000000WFWWWFWFW
0000000000WFFFFFFFW
0000000000WWWWWWWWW
