19 16
10 4
WWWWWW00000WWWW0000
WFFFFWWWWWWWFFWWWWW
WFFFBWFFWFFBFFWFFFW
WFFBFFBFFBFWFBFBFFW
WWBFBFFFWFFWFBFFFFW
WFFBFWWWWWWWWWWWFWW
WFWFFFWTTTTTTTWFBW0
WFWWFFWFTTTTTTWFFW0
WFWFFFBTTTTTTTTBFW0
WFWFBFWTTTTFTTWFFW0
WFFBFBWWWWBWWWWFBW0
WFBFFFWWWFBFFFBFFWW
WFBFFFFFBFBFFBFFFFW
WWFWWWWWWFBFWWWWWFW
WFFFFFFFFFWFFFFFFFW
WWWWWWWWWWWWWWWWWWW
