19 16
2 1
0WWW00WWWWWWWWWWWWW
WWFWWWWFFFFFFFWFFFW
WFBBFFFBBFFBFBFTTTW
WFFBBBWFFFFBFFWTTTW
WFBFFFWFBBFBBFWTTTW
WWWFFFWFFBFFFFWTTTW
WFFFFFWFBFBFBFWTTTW
WFFFFWWWWWWFWWWTTTW
WWFWFFWFFBFBFFWTTTW
WFFWWFWFBBFBFBWWTTW
WFTTWFWFFBFFFFFFWTW
WFTTWFWFBBBFBBBFWTW
WWWWWFWFFFFFFFWFWTW
0000WFWWWWWWWWWFWTW
0000WFFFFFFFFFFFWTW
0000WWWWWWWWWWWWWWW
