17 15
1 8
000000000WWWWW000
00000WWWWWFFFW000
0000WWFBFFBFFWWWW
WWWWWFBFFBFBFWWTW
WFFFFFFFBBFFWWTTW
WFFWWWWWWFWWWTTFW
WWFWFFWFFFFWTTTFW
WFBFFFWFFFFWTTTFW
WFFWBFWWFWWWWTTTW
WWWWFFBFBBFFWWTTW
000WWFFBFBFFBTTTW
0000WFBBFFBFWFFTW
0000WFFFBFBFFWWWW
0000WWWWWWFFFW000
000000000WWWWW000
