19 11
9 7
00000000WWWWWWW0000
0000WWWWWFFWFFWWWW0
0000WFFFWFFFBFFFFW0
0WWWWFWBBFWWFWWFFW0
WWFFFFFFWFWFFWWFWWW
WFFWWWFBWBFFBFFBFFW
WTTTFFFFWFWWFFWFFFW
WTTTWFFFFFFWFWWWFWW
WTTTWFFWWWFFBFFBFFW
WWWWWWWW0WWFFFWFFFW
0000000000WWWWWWWWW
