19 13
6 4
000WWWWWWWWW0000000
00WWFFFWWFFWWWWWW00
WWWFFFFFWFFWFFFFWWW
WFFBFWBFWFFWFFTTTFW
WFWFBWFBWWFWFWTWTFW
WFFWFWBFFWFFFFTFTFW
WFBFFFFBFWFWFWTWTFW
WFFFWWFFWWBFBFTFTFW
WFBFWFFFWFFWBWTWTFW
WWFBFFBFFFBFFBTTTFW
0WBFWWWWWWFFFFWWFFW
0WFFW0000WWWWWWWWWW
0WWWW00000000000000
