14 16
11 7
WWWWWWWWWW0000
WFFFFFFFFWWWW0
WFWWWWWWFWFFWW
WFWFBFBFBFFBFW
WFFFFFFFWBFFFW
WWWBFFBBWFFWWW
00WFFWWFWFBWW0
00WWBWFFFBFFW0
000WFFBFBFWWW0
000WFWFFFBFFW0
000WFWWFFFWFW0
00WWFFWWWWWFW0
00WFFFFFFFFFW0
00WTTTTTTTWWW0
00WTTTTTTTW000
00WWWWWWWWW000
