17 13
7 4
WWWWWWWWWWWWWWWW0
WFFFFFFFFFFFFFFW0
WFWFWWWWWWFFFFFW0
WFWFFBFBFBFBWFFW0
WFWFFFBFBFFFWWFWW
WFWFWBFBFBWWWTTTW
WFWFFFBFBFFWWTTTW
WFWWWBBBFBFWWTTTW
WFFFFFWFWWFWWTTTW
WWWWWFFFWWFWWTTTW
0000WWWWWFFFFFWWW
00000000WFFFFFW00
00000000WWWWWWW00
