19 14
3 7
0000WWWWWWW00000000
0000WFFWFFWWWW00000
WWWWWFBWBFWFFWW0000
WTTFWFFWFFWFFFW0000
WTTFWFBWBFWFFBWWWW0
WTFFWFFFFFWBFFWFFW0
WTTFFFBWFFWFBFFFFW0
WTTFWFFWBFWBFFWFFW0
WTTFWFBWFFFFFBWFFW0
WTTFWFFWBBWBFFWFFWW
WTTFWFBWFFWFFBWBFFW
WTTFWFFWFFWFFFWFFFW
WWTFWWWWFFWWWWWFFFW
0WWWW00WWWW000WWWWW
