13 15
1 4
000000WWWW000
00WWWWWFFW000
0WWFFFFFBW000
WWFBFFWWFWWW0
WFBFBFWFBFFW0
WWWWFWWFFFBW0
0WTTTTWBFBFW0
0WTTTTWFFFBW0
0WTTTTFFBBFWW
0WTTTFWFBFFFW
0WWWWWWBFBFFW
000000WFFFWWW
000000WBFWW00
000000WFFW000
000000WWWW000
