18 16
10 2
0000000WWWWWWW0000
0WWWWWWWFFFFFW0000
0WFFFFFWFBFBFW0000
0WBBFWFFFWWWWWWWWW
0WFWWWTTTTTTWWFFFW
0WFFFBTTTTTTWWFWFW
0WFWWWTTTTTTFFFFFW
WWFFFWWWWFWWWFWBWW
WFFWBFFFWFFBFFWFW0
WFFBFBBBFFWFBWWFW0
WFFFBFBFWWWBBFWFW0
WWWWWFFFFFBFFFWFW0
0000WWWFWWWFFFWFW0
000000WFFFFFWFFFW0
000000WWWWWWWWFFW0
0000000000000WWWW0
