11 11
8 1
000000WWWW0
WWWWWWWFFW0
WFFFFFBFFW0
WFFFBWWFBW0
WWBWTTTWFW0
0WFBTTTFFW0
0WFWTFTWFWW
0WFFFWFWBFW
0WBFFBFFFFW
0WFFWWWWWWW
0WWWW000000
