17 16
6 5
000WWWWWWWW000000
000WFFFWFFW000000
000WFFBFFFW000000
0WWWFWBFFFWWWW000
0WFFBFFWWBFFFW000
0WFFWFFFBFWFBW000
0WFFWFFFFFFBFWWWW
0WWFWWWWBWWFFFFFW
0WFBWTTTTTWFWFFFW
0WFFBTTCCTFBWFWWW
WWFFWTTTTTWFFFW00
WFFFWWWFWWWWWWW00
WFBBFFWFFW0000000
WFFWFFFFFW0000000
WWWWWWFFFW0000000
00000WWWWW0000000
