17 10
14 1
00000000WWWWWWWW0
00000000WFFFFFFW0
00000000WFBWBFWW0
00000000WFBFFBW00
00000000WWBFBFW00
WWWWWWWWWFBFWFWWW
WTTTTFFWWFBFFBFFW
WWTTTFFFFBFFBFFFW
WTTTTFFWWWWWWWWWW
WWWWWWWW000000000
