17 13
14 7
00000000WWWWW0000
00000000WFFFWWWWW
00000000WFWBWWFFW
00000000WFFFFFBFW
WWWWWWWWWFWWWFFFW
WTTTTFFWWFBFFBWWW
WTTTTFFFFBFBBFWW0
WTTTTFFWWBFFBFFW0
WWWWWWWWWFFBFFWW0
00000000WFBFBFFW0
00000000WWWFWWFW0
0000000000WFFFFW0
0000000000WWWWWW0
