17 16
15 3
0000WWWWWWWWWWWW0
0000WFFFFFFFFFFWW
0000WFFWFWBBFBFFW
0000WBFWBWFFWWFFW
000WWFWWFWFBFWFWW
000WFFFBFWBFFWFW0
000WFFFWFBFFFWFW0
000WWFBFBFFFWWFW0
000WFFWFFWWFFBFW0
000WFFFFWWFBBWFW0
WWWWWWBBFFFWFFFW0
WTTTTWFFWWWWWWWW0
WTWTTTFWW00000000
WTTTTFFFW00000000
WTTTTFFFW00000000
WWWWWWWWW00000000
