19 16
10 2
WWWWWWWWWWWW0WWWWWW
WFFFWFFFFWFWWWTTTTW
WFFFBBWFFFFFFTTTTTW
WFFFWFWWWFFFWFTTTTW
WWFWWFWWWFFWFFTTTTW
0WFBFBFFFFFWFWFWWWW
0WFFBFBWWFFWFFFFFFW
WWWWFWFFWWWWFWFWWFW
WFFWFWBFFFWWFWFFFFW
WFBFFBFFWFWWFWFFFWW
WFWFBFBFFFFWFWFFFW0
WFFBFWWFWWFWFWWWWW0
WFBBFFFFFBBFFW00000
WWFWWFWWWFBFFW00000
0WFFFFW0WFFFFW00000
0WWWWWW0WWWWWW00000
