15 12
13 9
0WWWWWWW0000000
0WFFWFFWWWWW000
WWFFWFFWTTTWWW0
WFFBWFFWTTTFFW0
WFBFWBBFTTTFFW0
WFFBWFFWTTTFTW0
WFFFWFBWWWWWWWW
WWBFFFFFFFBFBFW
0WFFWFFBBFWFFFW
0WWWWWWFFWWBBFW
000000WFFFFFFWW
000000WWWWWWWW0
