19 16
10 7
000000000000WWWWW00
WWWWW00WWWWWWFFFW00
WFFFWWWWFFBFBFBFW00
WFBFFFWWFWWFWWFFWW0
WFFFBFBFFFFFBFFBFW0
WWWFBFFWWFWWFFFFFWW
00WFWWWWWFWWWWWBBFW
0WWBWWWFWFFWWFFFFFW
0WFBFFWWWBWWWFBFFWW
0WFBFFWFFFWWWFFWWW0
0WFBBFBFWFFFBBFW000
0WFFFFFWFFFWWFFW000
0WWWWWWWTTFTWWWW000
0000WTTTTTTTTTW0000
0000WTTTTTTTTTW0000
0000WWWWWWWWWWW0000
