18 11
7 5
000000000WWWW00000
0WWWWWWWWWFFWW0000
WWFFBFFFFFFBFWWWWW
WFFFWWFWWFFFWWTTTW
WFWBBFBFBBWBWWTTTW
WFWFFFFFFFWFFFTTTW
WFFBWFWWWBBFFFTTTW
WFBFFBBFFBFWWTTTTW
WWWBFFFFFFFWWWWWWW
00WFFWWWWWWW000000
00WWWW000000000000
