19 17
2 7
000000WWWWWWWWWWWW0
00000WWTTFFFFWFFFW0
0000WWTTCFBFFFFBFW0
000WWTTCTWFWFWBFWW0
000WTTCTWFWFWFBFFW0
WWWWTTTWFFWFFFFWFW0
WFFWWFWFFFFFFFFFFW0
WFFBFBFWWWFFWFWFWW0
WFBFFFBFFFWFWFFFW00
WWWBBFFFWFWFWFWFW00
00WFFFBFFFWFWFWWWWW
00WFBWFWWWWWFFFFFFW
00WBFFFW000WFFFWFFW
00WFFWWW000WWFFFFFW
00WFFW000000WFFFFWW
00WWWW000000WWWWWW0
0000000000000000000
