19 16
11 3
0000000000000WWWWWW
0WWWWWWWWWWWWWTTTTW
WWFFFWWFFFFFWWTTTTW
WFFBBWWFFBFFWWTTTTW
WFFFFFFBBFBWFFTTTTW
WFFBFWWFBBFWFWFTTTW
WFFBFWWFBFFWFFTTTTW
WWFWWWWWFWWWFWWTWWW
WWFFFBFFBFWWFFFTFFW
WFBWWWFFWFWWWWWFWWW
WFFFBFFFWFFFFFFFW00
WFFBFWBFBFBWWWFFW00
WFBBBWFBFFFW0WWWW00
WFFFFWFFBBFW0000000
WWWWWWFFFWWW0000000
00000WWWWW000000000
