19 16
16 6
WWWW000000000000000
WFFWWWWWWWWWWWWWW00
WFFWFFFTTWTTTTTTW00
WFFWFWFWWWWWFTTTW00
WWBWFFFFTTTTTTTTW00
WFFFWWBWWWWWWFFWWWW
WFBFWFFFFFWFWWWWFFW
WWBFWFBFFFWWWWWWFFW
WFFBFWBBBWWFFFFFFFW
WFFFFFFWFFFFWBWBWWW
WFWWWWFWBBBBBFFFFW0
WFWFFFFBFFFFFWFFFW0
WFWFFFWWFWWFFFFFWWW
WFWWWWWWBWWWWWWFBFW
WFFFFFFFFW0000WFFFW
WWWWWWWWWW0000WWWWW
