14 10
7 4
WWWWWWWWWWWW00
WTTFFWFFFFFWWW
WTTFFWFBFFBFFW
WTTFFWBWWWWFFW
WTTFFFFFFWWFFW
WTTFFWFWFFBFWW
WWWWWWFWWBFBFW
00WFBFFBFBFBFW
00WFFFFWFFFFFW
00WWWWWWWWWWWW
